 ####
##  ####
#      ##
# **@** #
##  #   #
 # **$ ##
 #  *  #
 ## . ##
  ##  #
   ####