 #####
 # + #
 #$.$#
 # * #
 # * #
 # * ##
## *  #
#  *  #
#    ##
##  ##
 ####