##############
#            #
#      $$    #
#   @      ###
#            #
#     ..     #
###        ###
#            #
##############