    ####
    #  ###
  ###    #
### ** * #
#  . *$@##
#  ***  #
##    ###
 ###  #
   ####