  ####
 ##  #
##   ###
#  *** #
#  *@# #
## **. #
 #     #
 # #$###
 #   #
 #####