   ####
   #  #
####  ###
#  *$*  #
#  *@*# #
## .**  #
## #   ##
#    ###
#   ##
#####