#######
###     #
#   $$$ #####
# $#@ $   ..#
# $ $##$  ..#
#.        ..#
#.#####  ####
###   ####