   ####
 ###  ##
## * * #
#  * * ##
#  * *  #
#  $ * @#
###. ####
  #  #
  ####